1111111111111111111111111111
1000110000000010011000000011
1010101110111000000010101011
1010101111101011011100001011
1013000001100011100010011111
1011013000001011011010111101
1010010101010010001010001001
1001010000110111101011101101
1101011110100000001011101101
1130000010101101111001000001
1000101100001000011010101011
1101011011111101101101010011
1100011000011101101111011011
1011000101000001100011011021
1001010001110110101000000011
1101101000000110101011111001
1100000011010110001001100101
1111111111111111111111111111

